R 900 600

S ./texture/super.bmp
NO ./texture/super.bmp
SO ./texture/super.bmp
WE ./texture/super.bmp
EA ./texture/super.bmp


F 220,100,0
C 225,30,0



111111111
100000001
111100011
100N00001
111111111
