R 1920 1280

E ./texture/
W ./texture/
S ./texture/super.bmp
NO ./texture/super.bmp
SO ./texture/super.bmp
WE ./texture/super.bmp
EA ./texture/super.bmp
F ./texture/
C ./texture/



11111111111111111111
100010N0000000000001
10005000234343434001
111110000S0000000001
10005000234343434001
100010000000E0000001
11111000234343434001
    10000S0000000001
    1000234343434001
    100000000W000001
    1000234343434001
    1000000000000001
    1111111111111111