R 900 600
S ./texture/sprite.bmp
NO ./texture/earth.bmp
SO ./texture/shuttle.bmp
WE ./texture/super.bmp
EA ./texture/east.bmp
F 10,10,10
C 10,10,10


1111
11111111111111111111111
10000010000000000000001
10000000N00000000000001
11111110000111111111001
10000000000000000000001
10000010000000000000001
10000010000111111111001
11111110000000000000001
10000000000000000000001
10000010200111111111001
11111110000000000000001
      10000000000000001
      10000111111111001
      10000000000000001
      10000000000000001
      10000111111111001
      10000000000000001
      10000000000000001
      10000111111111001
      10000000000000001
      10000000000000001
      10000111111111001
      10000000000000001
      10000000000000001
      11111111111111111